***********************************
*.................................*
*.................................*
*.................................*
*..................****************
*.......E..........*..............*
*..................*..............*
*..................*.....*........*
*..................*.....*........* 
*........................*........*
*........................*........*
*..................****************
*..................*...............
*..................*...............
*..................*...............
*..................*...............
*..................*...............
*..................*...............
*..................*...............
*..................*...............
*............P.....*...............
*..................*...............
********************...............